Player,Pos,Age,Tm,G,GS,MP,FG,FGA,3P,3PA,2P,2PA,FT,FTA,ORB,DRB,TRB,AST,STL,BLK,TOV,PF,PTS,Salary
Precious Achiuwa,PF,21,MIA,61,4,737,124,228,0,1,124,227,56,110,73,135,208,29,20,28,43,91,304,"2,582,160"
Jaylen Adams,PG,24,MIL,7,0,18,1,8,0,2,1,6,0,0,0,3,3,2,0,0,0,1,2,"449,115"
Steven Adams,C,27,NOP,58,58,1605,189,308,0,3,189,305,60,135,213,301,514,111,54,38,78,113,438,"29,592,695"
Bam Adebayo,C,23,MIA,64,64,2143,456,800,2,8,454,792,283,354,142,431,573,346,75,66,169,145,1197,"5,115,492"
LaMarcus Aldridge,C,35,TOT,26,23,674,140,296,31,80,109,216,41,47,19,99,118,49,11,29,27,47,352,"17,628,340"
Ty-Shon Alexander,SG,22,PHO,15,0,47,3,12,2,9,1,3,1,2,2,8,10,6,0,1,3,2,9,"449,115"
Nickeil Alexander-Walker,SG,22,NOP,46,13,1007,192,458,76,219,116,239,48,66,13,131,144,102,47,22,69,88,508,"3,113,160"
Grayson Allen,SG,25,MEM,50,38,1259,173,414,107,274,66,140,79,91,19,141,160,108,46,8,48,71,532,"2,545,320"
Jarrett Allen,C,22,TOT,63,45,1864,298,482,6,19,292,463,204,290,196,435,631,106,32,90,100,96,806,"3,909,902"
Al-Farouq Aminu,PF,30,TOT,23,14,434,38,99,8,37,30,62,18,22,22,88,110,31,19,9,28,29,102,"9,720,900"
Kyle Anderson,PF,27,MEM,69,69,1887,308,658,94,261,214,397,144,184,52,344,396,250,84,57,86,120,854,"9,505,100"
Giannis Antetokounmpo,PF,26,MIL,61,61,2013,626,1100,67,221,559,879,398,581,97,574,671,357,72,73,207,168,1717,"27,528,088"
Kostas Antetokounmpo,PF,23,LAL,15,0,56,3,10,0,0,3,10,6,13,4,15,19,1,2,4,11,8,12,"449,115"
Thanasis Antetokounmpo,SF,28,MIL,57,3,551,67,137,7,29,60,108,25,49,54,70,124,46,22,10,43,74,166,"1,701,593"
Carmelo Anthony,PF,36,POR,69,3,1690,327,777,133,325,194,452,137,154,32,182,214,104,46,38,61,144,924,"2,564,753"
Cole Anthony,PG,20,ORL,47,34,1273,219,552,58,172,161,380,109,131,38,183,221,192,30,18,106,98,605,"3,285,120"
OG Anunoby,SF,23,TOR,43,43,1433,249,519,104,261,145,258,80,102,54,183,237,94,66,32,75,114,682,"3,872,215"
Ryan Arcidiacono,PG,26,CHI,44,0,450,49,117,25,67,24,50,13,20,5,62,67,56,9,0,10,47,136,"3,000,000"
Trevor Ariza,SF,35,MIA,30,27,841,99,241,50,143,49,98,34,44,27,117,144,55,31,18,21,55,282,"12,800,000"
Deni Avdija,SF,20,WAS,54,32,1257,130,312,53,168,77,144,29,45,22,240,262,63,32,15,33,140,342,"4,469,160"
Deandre Ayton,C,22,PHO,69,69,2115,430,687,4,20,426,667,133,173,228,499,727,99,41,81,103,196,997,"10,018,200"
Udoka Azubuike,C,21,UTA,15,0,57,4,9,0,0,4,9,8,10,4,9,13,0,1,4,3,9,16,"1,977,000"
Dwayne Bacon,SG,25,ORL,72,50,1853,292,726,59,207,233,519,145,176,31,193,224,93,45,5,46,103,788,"1,678,854"
LaMelo Ball,PG,19,CHO,51,31,1469,293,672,92,261,201,411,125,165,63,239,302,313,81,18,145,136,803,"7,839,960"
Lonzo Ball,PG,23,NOP,55,55,1747,290,700,172,455,118,245,50,64,33,230,263,316,82,31,123,103,802,"11,003,782"
Mo Bamba,C,22,ORL,46,5,725,142,301,38,118,104,183,45,66,76,189,265,35,14,58,36,87,367,"5,969,040"
Desmond Bane,SG,22,MEM,68,17,1519,234,499,117,271,117,228,40,49,31,179,210,118,41,16,59,125,625,"1,936,440"
Harrison Barnes,PF,28,SAC,58,58,2102,319,642,100,256,219,386,195,235,64,321,385,201,43,11,93,75,933,"22,215,909"
RJ Barrett,SG,20,NYK,72,72,2511,467,1060,124,309,343,751,206,276,68,346,414,217,53,20,139,188,1264,"8,231,760"
Will Barton,SF,30,DEN,56,52,1736,259,608,98,257,161,351,95,121,39,187,226,181,50,23,96,95,711,"13,723,214"
Keita Bates-Diop,SF,25,SAS,30,0,245,30,67,5,17,25,50,14,21,9,40,49,12,11,5,7,11,79,"449,115"
Nicolas Batum,SF,32,LAC,67,38,1835,191,412,110,272,81,140,48,58,50,266,316,148,69,37,53,102,540,"11,608,231"
Aron Baynes,C,34,TOR,53,31,980,134,304,27,103,107,201,29,41,87,186,273,47,17,23,46,119,324,"7,000,000"
Kent Bazemore,SF,31,GSW,67,18,1333,176,392,75,184,101,208,54,78,26,203,229,108,69,33,82,158,481,"2,320,044"
Darius Bazley,PF,20,OKC,55,55,1714,273,690,83,286,190,404,125,178,51,345,396,99,29,25,122,60,754,"2,399,160"
Bradley Beal,SG,27,WAS,60,60,2147,670,1382,130,373,540,1009,408,459,72,211,283,265,69,22,187,140,1878,"28,751,774"
Malik Beasley,SG,24,MIN,37,36,1214,264,600,128,321,136,279,68,80,28,134,162,88,30,7,60,62,724,"13,425,895"
Jordan Bell,C,26,TOT,6,1,82,7,22,0,2,7,20,1,2,7,17,24,7,3,5,4,7,15,"592,368"
Patrick Beverley,PG,32,LAC,37,34,832,93,220,56,141,37,79,36,45,29,90,119,76,29,28,34,108,278,"13,333,333"
Saddiq Bey,SF,21,DET,70,53,1909,279,691,175,460,104,231,124,147,43,275,318,95,52,14,60,110,857,"2,689,920"
Tyler Bey,SF,22,DAL,18,0,71,7,22,1,4,6,18,3,5,8,11,19,3,0,1,3,6,18,"449,115"
Khem Birch,C,28,TOT,67,22,1529,189,380,13,52,176,328,91,129,174,213,387,89,48,50,44,113,482,"3,011,499"
Goga Bitadze,C,21,IND,45,3,561,83,194,20,79,63,115,45,61,60,90,150,37,9,60,17,94,231,"2,957,520"
Bismack Biyombo,C,28,CHO,66,36,1349,142,242,0,1,142,241,47,105,137,210,347,81,17,74,71,141,331,"3,500,000"
Nemanja Bjelica,PF,32,TOT,37,3,595,89,196,27,85,62,111,37,51,29,98,127,69,15,5,33,68,242,"7,150,000"
Eric Bledsoe,SG,31,NOP,71,70,2111,307,730,121,355,186,375,134,195,29,215,244,268,55,24,114,112,869,"16,875,000"
Keljin Blevins,SF,25,POR,17,0,75,5,20,2,8,3,12,0,0,3,7,10,4,2,0,5,8,12,"449,115"
Bol Bol,PF,21,DEN,32,2,160,25,58,9,24,16,34,10,15,0,24,24,7,3,10,13,14,69,"2,058,240"
Marques Bolden,C,22,CLE,6,0,29,1,3,0,0,1,3,5,8,3,3,6,0,2,2,2,0,7,"449,115"
Jordan Bone,PG,23,ORL,14,0,196,23,54,10,32,13,22,0,0,4,20,24,18,2,0,3,11,56,"135,350"
Isaac Bonga,SF,21,WAS,40,8,432,30,81,13,47,17,34,5,8,18,48,66,23,11,9,22,63,78,"1,663,861"
Devin Booker,SG,24,PHO,67,67,2270,623,1287,126,371,497,916,340,392,34,247,281,289,53,16,207,181,1712,"29,467,800"
Chris Boucher,C,28,TOR,60,14,1453,288,560,90,235,198,325,152,193,117,287,404,63,35,111,46,166,818,"6,500,000"
Brian Bowen,SF,22,IND,6,0,15,1,4,0,1,1,3,1,1,0,3,3,0,0,0,0,1,3,"375,321"
Avery Bradley,SG,30,TOT,27,6,602,64,171,33,101,31,70,12,15,8,49,57,46,21,3,28,55,173,"5,635,000"
Tony Bradley,C,23,TOT,42,8,684,131,197,0,3,131,194,38,55,85,154,239,37,15,30,33,61,300,"3,542,060"
Jarrell Brantley,PF,24,UTA,28,0,138,25,52,12,28,13,24,2,2,9,18,27,15,7,2,8,17,64,"510,586"
Ignas Brazdeikis,SF,22,TOT,13,0,249,35,83,11,28,24,55,10,14,11,34,45,17,4,3,12,22,91,"1,686,315"
Mikal Bridges,SF,24,PHO,72,72,2348,363,669,134,315,229,354,110,131,76,233,309,152,76,63,57,116,970,"4,359,000"
Miles Bridges,PF,22,CHO,66,19,1932,313,622,116,290,197,332,98,113,81,316,397,147,44,52,106,143,840,"3,934,320"
Amida Brimah,C,26,IND,5,0,29,5,8,0,0,5,8,3,3,2,6,8,1,0,5,4,4,13,"123,056"
Oshae Brissett,SF,22,IND,21,16,519,73,151,33,78,40,73,50,65,29,86,115,18,19,20,10,32,229,"1,255,493"
Malcolm Brogdon,PG,28,IND,56,56,1930,444,980,145,374,299,606,153,177,58,236,294,329,49,15,115,110,1186,"20,700,000"
Armoni Brooks,SG,22,HOU,20,5,520,78,192,60,157,18,35,7,12,10,58,68,30,12,5,22,34,223,"135,362"
Dillon Brooks,SF,25,MEM,67,67,1997,432,1031,128,372,304,659,159,195,53,143,196,157,78,26,119,237,1151,"11,400,000"
Bruce Brown,PG,24,BRK,65,37,1451,235,423,17,59,218,364,86,117,111,238,349,104,58,28,54,145,573,"1,663,861"
Jaylen Brown,SG,24,BOS,58,58,1999,538,1111,163,411,375,700,191,250,71,276,347,195,72,32,158,168,1430,"25,035,118"
Moses Brown,C,21,OKC,43,32,920,146,268,0,0,146,268,78,126,154,229,383,10,31,47,43,93,370,"1,250,000"
Sterling Brown,SG,25,HOU,51,14,1229,150,335,91,215,59,120,25,31,38,186,224,72,38,12,41,97,416,"1,678,854"
Jalen Brunson,PG,24,DAL,68,12,1697,328,627,81,200,247,427,120,151,27,204,231,239,35,1,80,109,857,"1,663,861"
Elijah Bryant,SG,25,MIL,1,0,32,6,13,1,5,5,8,3,3,2,4,6,3,0,1,4,4,16,"24,611"
Thomas Bryant,C,23,WAS,10,10,271,59,91,9,21,50,70,16,24,18,43,61,15,4,8,11,31,143,"8,333,333"
Reggie Bullock,SF,29,NYK,65,64,1949,248,561,163,398,85,163,50,55,16,207,223,99,52,11,45,146,709,"4,200,000"
Trey Burke,PG,28,DAL,62,1,911,151,353,58,164,93,189,51,57,10,44,54,81,36,7,33,64,411,"3,000,000"
Alec Burks,SG,29,NYK,49,5,1255,210,500,102,246,108,254,101,118,21,206,227,107,31,14,49,102,623,"6,000,000"
Jimmy Butler,SF,31,MIA,52,52,1745,366,736,25,102,341,634,359,416,94,265,359,369,108,18,109,71,1116,"34,379,100"
Bruno Caboclo,PF,25,HOU,6,0,36,8,17,0,5,8,12,1,2,3,11,14,1,0,2,4,6,17,"2,028,594"
Devontae Cacok,PF,24,LAL,20,1,98,17,29,0,0,17,29,5,11,12,20,32,1,5,4,5,8,39,"449,115"
Kentavious Caldwell-Pope,SG,27,LAL,67,67,1902,218,506,120,293,98,213,97,112,27,152,179,127,62,26,66,114,653,"12,073,020"
Facundo Campazzo,PG,29,DEN,65,19,1425,120,315,76,216,44,99,80,91,22,112,134,232,79,14,73,132,396,"3,200,000"
Clint Capela,C,26,ATL,63,63,1898,413,695,0,0,413,695,130,227,297,606,903,49,44,129,73,145,956,"18,000,000"
Jevon Carter,PG,25,PHO,60,1,717,94,223,56,151,38,72,4,7,16,76,92,71,29,9,16,56,248,"3,925,000"
Michael Carter-Williams,SG,29,ORL,31,25,800,105,270,15,61,90,209,49,80,39,100,139,129,25,17,69,81,274,"3,300,000"
Alex Caruso,PG,26,LAL,58,6,1216,133,305,55,137,78,168,49,76,31,139,170,160,64,15,76,108,370,"2,750,000"
Willie Cauley-Stein,C,27,DAL,53,16,906,115,182,1,11,114,171,49,78,66,170,236,35,21,43,29,129,280,"4,100,000"
Chris Chiozza,PG,25,BRK,22,1,232,31,88,13,42,18,46,13,17,3,21,24,65,7,6,16,19,88,"449,115"
Marquese Chriss,PF,23,GSW,2,0,27,5,14,1,5,4,9,2,4,3,10,13,2,0,2,2,3,13,"1,824,003"
Gary Clark,SF,26,TOT,39,11,654,40,132,31,108,9,24,8,10,33,82,115,31,13,7,17,35,119,"2,018,458"
Brandon Clarke,PF,24,MEM,59,16,1415,256,495,20,77,236,418,78,113,97,231,328,95,60,51,33,84,610,"2,602,920"
Jordan Clarkson,SG,28,UTA,68,1,1818,457,1075,208,599,249,476,129,144,47,227,274,168,61,10,115,110,1251,"11,500,000"
Amir Coffey,SG,23,LAC,44,1,394,45,103,23,56,22,47,27,38,10,34,44,22,10,0,15,30,140,"578,842"
John Collins,PF,23,ATL,63,63,1848,429,771,83,208,346,563,170,204,118,349,467,78,34,63,84,193,1111,"4,137,302"
Mike Conley,PG,33,UTA,51,51,1498,284,640,138,335,146,305,121,142,36,141,177,305,70,9,99,98,827,"34,502,132"
Pat Connaughton,SG,28,MIL,69,4,1575,168,387,101,272,67,115,31,40,63,269,332,81,49,23,33,99,468,"4,938,273"
Quinn Cook,PG,27,TOT,23,0,157,29,68,11,26,18,42,7,8,2,15,17,18,4,1,7,10,76,"1,981,649"
Tyler Cook,SF,23,TOT,32,1,438,69,103,1,2,68,101,17,35,28,67,95,17,8,2,21,35,156,"693,141"
DeMarcus Cousins,C,30,TOT,41,11,713,130,305,47,135,83,170,59,81,53,210,263,76,34,24,64,107,366,"3,051,832"
Robert Covington,PF,30,POR,70,70,2243,204,509,135,356,69,153,50,62,61,405,466,117,101,84,64,195,593,"12,138,345"
Torrey Craig,SF,30,TOT,50,8,803,109,227,39,106,70,121,17,22,57,140,197,49,28,26,25,83,274,"1,678,854"
Jae Crowder,PF,30,PHO,60,42,1648,199,492,148,380,51,112,57,75,32,250,282,127,48,27,55,125,603,"9,258,000"
Jarrett Culver,SG,21,MIN,34,7,499,69,168,13,53,56,115,29,48,34,70,104,24,17,9,28,58,180,"6,104,280"
Seth Curry,SG,30,PHI,57,57,1638,258,552,126,280,132,272,69,77,10,126,136,155,44,8,65,96,711,"7,834,449"
Stephen Curry,PG,32,GSW,63,63,2152,658,1365,337,801,321,564,362,395,29,316,345,363,77,8,213,119,2015,"43,006,362"
Nate Darling,SG,22,CHO,7,0,26,2,7,2,7,0,0,3,3,1,0,1,1,0,1,1,1,9,"449,115"
Anthony Davis,PF,27,LAL,36,36,1162,301,613,26,100,275,513,158,214,62,224,286,110,45,59,74,60,786,"32,742,000"
Ed Davis,C,31,MIN,23,7,299,19,44,0,0,19,44,10,12,46,69,115,21,13,13,7,56,48,"5,005,350"
Terence Davis,SG,23,TOT,61,4,1074,195,456,98,267,97,189,45,55,20,134,154,83,44,14,63,97,533,"1,517,981"
Gabriel Deck,PF,25,OKC,10,0,212,32,67,2,15,30,52,18,22,16,24,40,24,8,0,6,9,84,"3,870,370"
Dewayne Dedmon,C,31,MIA,16,0,210,46,65,1,5,45,60,20,27,28,58,86,12,9,6,13,36,113,"3,447,478"
Matthew Dellavedova,PG,30,CLE,13,1,224,14,56,4,25,10,31,4,4,6,18,24,58,4,1,6,21,36,"2,174,318"
DeMar DeRozan,PF,31,SAS,61,61,2056,455,920,19,74,436,846,387,440,40,219,259,422,56,15,119,128,1316,"27,739,975"
Mamadi Diakite,PF,24,MIL,14,1,141,16,40,1,8,15,32,11,14,8,26,34,8,7,6,3,16,44,"529,341"
Hamidou Diallo,SG,22,TOT,52,9,1226,224,470,28,82,196,388,128,200,59,213,272,101,41,24,76,134,604,"1,663,861"
Gorgui Dieng,C,31,TOT,38,1,552,85,163,30,70,55,93,58,67,40,100,140,48,26,16,32,56,258,"17,587,688"
Spencer Dinwiddie,SG,27,BRK,3,3,64,6,16,2,7,4,9,6,6,0,13,13,9,2,1,5,4,20,"11,454,048"
Donte DiVincenzo,SG,24,MIL,66,66,1814,253,603,131,346,122,257,51,71,81,299,380,203,72,15,91,112,688,"3,044,160"
Luguentz Dort,SG,21,OKC,52,52,1543,247,639,113,329,134,310,122,164,38,151,189,88,45,19,79,134,729,"1,517,981"
Damyean Dotson,SG,26,CLE,46,7,907,119,293,46,159,73,134,24,36,5,88,93,91,16,4,42,42,308,"2,000,000"
Devon Dotson,PG,21,CHI,11,0,50,11,21,1,7,10,14,0,0,2,3,5,7,4,0,0,3,23,"449,115"
Sekou Doumbouya,PF,20,DET,56,11,869,107,282,26,115,81,167,45,64,39,104,143,47,24,9,44,94,285,"3,449,400"
PJ Dozier,SG,24,DEN,50,6,1088,148,355,47,149,101,206,42,66,35,147,182,92,31,22,46,86,385,"1,762,796"
Andre Drummond,C,27,TOT,46,46,1242,282,572,0,8,282,564,123,205,166,385,551,94,63,49,124,149,687,"28,751,774"
Jared Dudley,PF,35,LAL,12,0,81,2,9,2,6,0,3,0,0,4,17,21,5,1,1,2,7,6,"2,564,753"
Kris Dunn,PG,26,ATL,4,0,45,1,12,0,2,1,10,3,4,0,6,6,2,2,2,3,10,5,"4,767,000"
Kevin Durant,PF,32,BRK,35,32,1157,324,603,85,189,239,414,210,238,13,234,247,195,25,45,120,70,943,"40,108,950"
Anthony Edwards,SG,19,MIN,72,55,2314,505,1211,171,520,334,691,211,272,59,277,336,211,82,36,160,129,1392,"9,757,440"
Carsen Edwards,SG,22,BOS,31,1,276,47,111,18,63,29,48,11,13,3,23,26,14,7,1,7,25,123,"1,517,981"
CJ Elleby,SF,20,POR,30,0,192,25,66,7,34,18,32,11,15,11,21,32,10,6,3,5,27,68,"898,310"
Henry Ellenson,PF,24,TOR,2,0,38,5,14,2,9,3,5,3,4,3,9,12,5,0,0,0,7,15,"168,983"
Wayne Ellington,SG,33,DET,46,31,1012,149,338,116,275,33,63,28,35,12,73,85,67,18,9,33,59,442,"3,564,753"
Joel Embiid,C,26,PHI,51,51,1585,461,899,58,154,403,745,471,548,113,426,539,145,50,69,159,123,1451,"29,542,010"
Drew Eubanks,C,23,SAS,54,3,755,116,205,2,2,114,203,77,106,74,167,241,42,18,49,45,88,311,"1,620,564"
Dante Exum,SG,25,CLE,6,3,116,10,26,2,11,8,15,1,2,2,15,17,13,4,2,7,9,23,"9,600,000"
Tacko Fall,C,25,BOS,19,0,136,21,29,0,0,21,29,5,15,16,36,52,3,1,20,6,22,47,"653,924"
Derrick Favors,C,29,UTA,68,0,1039,155,243,0,2,155,241,59,80,138,238,376,44,32,68,36,143,369,"9,258,000"
Terrance Ferguson,SG,22,PHI,13,0,49,1,7,0,5,1,2,0,0,0,1,1,2,1,0,4,7,2,"3,944,013"
Bruno Fernando,C,22,ATL,33,0,226,18,44,0,2,18,42,15,22,16,62,78,10,4,3,21,23,51,"1,517,981"
Yogi Ferrell,PG,27,TOT,10,0,136,20,57,9,28,11,29,7,9,5,14,19,22,7,3,3,11,56,"444,149"
Dorian Finney-Smith,PF,27,DAL,60,60,1921,220,466,119,302,101,164,31,41,98,228,326,102,52,25,48,138,590,"4,000,000"
Malik Fitts,PF,23,LAC,3,0,11,1,3,1,2,0,1,0,0,0,3,3,0,0,0,0,3,3,"61,528"
Malachi Flynn,PG,22,TOR,47,14,928,127,340,54,168,73,172,45,56,10,106,116,137,38,7,43,68,353,"1,950,600"
Bryn Forbes,SG,27,MIL,70,10,1354,250,529,154,341,96,188,47,61,11,101,112,45,24,1,44,77,701,"2,337,145"
Trent Forrest,PG,22,UTA,30,0,302,32,71,5,26,27,45,19,19,11,33,44,45,9,4,21,22,88,"470,690"
Evan Fournier,SF,28,TOT,42,36,1259,247,541,117,283,130,258,108,137,10,118,128,144,47,19,73,96,719,"17,150,000"
De'Aaron Fox,PG,23,SAC,58,58,2036,529,1110,103,320,426,790,300,417,33,170,203,417,87,27,174,170,1461,"8,099,627"
Tim Frazier,PG,30,MEM,5,0,62,3,20,0,8,3,12,2,6,0,8,8,16,2,1,4,7,8,"597,463"
Markelle Fultz,PG,22,ORL,8,8,215,41,104,4,16,37,88,17,19,5,20,25,43,8,2,18,18,103,"12,288,697"
Wenyen Gabriel,PF,23,NOP,21,0,241,24,60,13,32,11,28,11,17,20,34,54,11,9,8,15,32,72,"1,620,564"
Daniel Gafford,PF,22,TOT,54,11,791,154,225,0,0,154,225,72,108,94,137,231,29,26,75,41,98,380,"1,517,981"
Danilo Gallinari,PF,32,ATL,51,4,1222,206,475,103,254,103,221,161,174,17,194,211,76,30,10,43,105,676,"19,500,000"
Langston Galloway,SG,29,PHO,40,0,438,66,147,36,85,30,62,22,23,7,35,42,26,8,0,13,25,190,"2,028,594"
Darius Garland,PG,21,CLE,54,50,1790,362,802,105,266,257,536,112,132,23,106,129,329,66,6,164,110,941,"6,720,720"
Marc Gasol,C,36,LAL,52,42,993,88,194,50,122,38,72,36,50,38,177,215,109,26,58,53,115,262,"2,564,753"
Rudy Gay,PF,34,SAS,63,1,1358,264,628,106,278,158,350,82,102,42,261,303,88,45,40,65,115,716,"14,500,000"
Paul George,SF,30,LAC,54,54,1821,445,953,171,416,274,537,198,228,45,314,359,280,62,24,179,132,1259,"35,450,412"
Taj Gibson,C,35,NYK,45,3,936,99,158,3,15,96,143,40,55,99,151,250,36,31,49,22,99,241,"3,283,684"
Harry Giles,C,22,POR,38,0,348,42,97,8,23,34,74,16,27,31,102,133,29,8,13,20,54,108,"1,620,564"
Shai Gilgeous-Alexander,SG,22,OKC,35,35,1180,287,565,71,170,216,395,185,229,19,147,166,207,27,23,106,70,830,"4,141,320"
Anthony Gill,PF,28,WAS,26,4,218,30,60,7,24,23,36,13,16,16,35,51,11,10,4,8,27,80,"898,310"
Freddie Gillespie,PF,23,TOR,20,2,392,44,84,0,0,44,84,23,33,42,55,97,9,13,20,12,43,111,"363,015"
Rudy Gobert,C,28,UTA,71,71,2187,391,579,0,4,391,575,233,374,240,720,960,89,40,190,118,163,1015,"27,525,281"
Brandon Goodwin,PG,25,ATL,47,5,620,84,223,32,103,52,120,28,43,8,61,69,95,17,0,36,41,228,"1,701,593"
Aaron Gordon,PF,25,TOT,50,50,1384,231,499,59,176,172,323,97,149,77,207,284,161,33,34,97,89,618,"18,136,364"
Eric Gordon,SG,32,HOU,27,13,789,159,367,69,210,90,157,94,114,8,50,58,71,14,13,51,44,481,"16,869,267"
Jerami Grant,SF,26,DET,54,54,1829,400,932,115,329,285,603,290,343,35,215,250,152,35,58,109,125,1205,"19,050,000"
Danny Green,SF,33,PHI,69,69,1934,224,544,175,432,49,112,31,40,55,205,260,118,92,56,67,125,654,"15,365,853"
Draymond Green,PF,30,GSW,63,63,1982,170,380,34,126,136,254,70,88,55,394,449,558,105,52,188,194,444,"22,246,956"
JaMychal Green,PF,30,DEN,58,5,1120,173,374,79,198,94,176,46,57,85,192,277,53,26,22,53,144,471,"7,199,760"
Javonte Green,SF,27,TOT,41,2,473,53,102,10,30,43,72,30,40,26,45,71,17,28,6,19,45,146,"1,517,981"
Jeff Green,PF,34,BRK,68,38,1835,261,530,103,250,158,280,125,161,34,229,263,108,36,27,54,122,750,"2,564,753"
Josh Green,SG,20,DAL,39,5,445,42,93,4,25,38,68,13,23,28,50,78,28,16,3,17,35,101,"2,816,760"
Blake Griffin,PF,31,TOT,46,30,1186,174,411,70,205,104,206,87,117,35,190,225,140,32,15,62,111,505,"33,900,241"
Kyle Guy,PG,23,SAC,31,0,235,29,88,13,46,16,42,16,20,5,30,35,32,6,0,11,20,87,"537,888"
Rui Hachimura,PF,22,WAS,57,57,1797,310,648,45,137,265,511,124,161,49,263,312,82,44,7,68,120,789,"4,692,840"
Ashton Hagans,PG,21,MIN,2,0,4,0,0,0,0,0,0,0,0,0,0,0,0,0,0,1,0,0,"166,111"
Tyrese Haliburton,PG,20,SAC,58,20,1746,292,619,121,296,171,323,48,56,39,134,173,309,77,28,92,83,753,"3,831,840"
Donta Hall,PF,23,ORL,13,0,179,25,35,0,0,25,35,23,34,24,38,62,11,5,10,8,18,73,"376,276"
Josh Hall,SF,20,OKC,21,1,336,30,99,4,37,26,62,22,44,6,53,59,28,4,1,25,37,86,"449,115"
James Harden,PG,31,TOT,44,43,1609,342,734,121,334,221,400,278,323,35,313,348,475,53,33,177,99,1083,"41,254,920"
Jared Harper,PG,23,NYK,8,0,16,0,4,0,1,0,3,3,4,0,2,2,1,0,0,3,1,3,"520,487"
Montrezl Harrell,C,27,LAL,69,1,1580,375,603,0,10,375,593,181,256,158,270,428,73,46,49,74,128,931,"9,258,000"
Gary Harris,SG,26,TOT,39,38,1080,138,345,48,141,90,204,64,78,21,58,79,78,28,11,37,71,388,"19,610,714"
Jalen Harris,SG,22,TOR,13,2,172,36,72,17,36,19,36,7,9,3,15,18,17,8,0,14,15,96,"449,115"
Joe Harris,SF,29,BRK,69,65,2141,357,707,211,444,146,263,49,63,43,205,248,130,46,14,62,141,974,"16,071,429"
Tobias Harris,PF,28,PHI,62,62,2014,473,924,82,208,391,716,182,204,62,357,419,220,55,51,107,119,1210,"34,358,850"
Shaquille Harrison,SG,27,TOT,34,0,333,26,78,3,16,23,62,18,22,7,41,48,25,17,5,11,33,73,"915,048"
Josh Hart,SF,25,NOP,47,4,1349,151,344,63,193,88,151,69,89,53,324,377,109,38,12,49,111,434,"3,491,159"
Isaiah Hartenstein,C,22,TOT,46,2,559,94,171,2,6,92,165,46,71,65,116,181,55,19,39,44,104,236,"1,620,564"
Udonis Haslem,C,40,MIA,1,0,3,2,2,0,0,2,2,0,0,0,1,1,0,0,0,0,0,4,"2,564,753"
Jaxson Hayes,C,20,NOP,60,3,964,175,280,6,14,169,266,93,120,92,165,257,35,25,38,39,101,449,"5,105,160"
Killian Hayes,PG,19,DET,26,18,670,71,201,20,72,51,129,14,17,6,63,69,138,27,10,83,57,176,"5,307,120"
Gordon Hayward,SF,30,CHO,44,44,1496,311,658,85,205,226,453,156,185,37,221,258,181,52,14,91,74,863,"28,500,000"
Tyler Herro,SG,21,MIA,54,15,1635,307,699,107,297,200,402,94,117,25,243,268,184,35,17,101,71,815,"3,822,240"
Buddy Hield,SG,28,SAC,71,71,2433,403,992,282,721,121,271,88,104,29,305,334,257,63,30,130,175,1176,"24,931,817"
George Hill,PG,34,TOT,30,17,672,95,197,31,80,64,117,40,50,16,45,61,73,23,5,31,31,261,"9,590,602"
Solomon Hill,PF,29,ATL,71,16,1513,107,298,68,212,39,86,35,46,42,172,214,75,50,11,42,116,317,"2,174,318"
Nate Hinton,SG,21,DAL,21,0,93,15,42,4,19,11,23,7,10,1,8,9,8,7,2,5,8,41,"449,115"
Jaylen Hoard,SF,21,OKC,19,0,320,44,88,0,11,44,77,28,41,21,44,65,24,13,5,17,19,116,"129,209"
Aaron Holiday,PG,24,IND,66,8,1176,170,436,67,182,103,254,68,83,15,74,89,123,46,13,66,94,475,"2,345,640"
Jrue Holiday,PG,30,MIL,59,56,1907,414,823,111,283,303,540,107,136,73,195,268,357,96,37,127,98,1046,"27,026,011"
Justin Holiday,SG,31,IND,72,52,2183,258,625,173,453,85,172,67,85,32,224,256,119,74,41,54,135,756,"5,720,400"
Rondae Hollis-Jefferson,PF,26,POR,11,1,107,9,18,0,1,9,17,9,16,11,15,26,13,2,4,2,15,27,"502,957"
Richaun Holmes,C,27,SAC,61,61,1782,366,575,2,11,364,564,135,170,144,360,504,101,39,96,75,213,869,"5,005,350"
Rodney Hood,SF,28,TOT,55,5,942,94,260,34,113,60,147,24,28,23,80,103,53,24,7,36,74,246,"10,047,450"
Al Horford,C,34,OKC,28,28,782,162,360,56,152,106,208,18,22,29,159,188,94,25,26,29,48,398,"27,500,000"
Talen Horton-Tucker,SG,20,LAL,65,4,1304,224,489,37,131,187,358,100,129,25,144,169,181,63,21,105,127,585,"1,517,981"
Dwight Howard,C,35,PHI,69,6,1196,178,303,5,20,173,283,121,210,190,390,580,61,30,62,112,200,482,"2,564,753"
Markus Howard,SG,21,DEN,37,1,205,40,106,18,65,22,41,7,9,1,20,21,18,4,1,18,23,105,"535,294"
Kevin Huerter,SG,22,ATL,69,49,2126,316,731,140,386,176,345,50,64,38,193,231,241,82,18,79,165,822,"2,761,920"
Elijah Hughes,SF,22,UTA,18,0,64,10,30,8,23,2,7,3,4,1,8,9,6,1,1,6,1,31,"898,310"
De'Andre Hunter,SF,23,ATL,23,19,678,120,248,31,95,89,153,73,85,17,93,110,44,19,12,29,59,344,"7,422,000"
Chandler Hutchison,SF,24,TOT,25,1,346,39,103,8,22,31,81,21,25,6,72,78,17,12,5,20,33,107,"2,443,440"
Serge Ibaka,C,31,LAC,41,39,955,186,365,39,115,147,250,43,53,73,202,275,74,9,47,44,76,454,"9,258,000"
Andre Iguodala,SF,37,MIA,63,5,1339,95,248,60,182,35,66,25,38,38,183,221,142,57,35,67,90,275,"15,000,000"
Joe Ingles,SF,33,UTA,67,30,1867,275,562,183,406,92,156,76,90,27,217,244,318,45,12,117,120,809,"10,363,637"
Brandon Ingram,SF,23,NOP,61,61,2093,513,1101,143,375,370,726,281,320,34,265,299,296,42,36,154,124,1450,"27,285,000"
Kyrie Irving,PG,28,BRK,54,54,1886,549,1086,152,378,397,708,201,218,52,205,257,324,76,37,130,140,1451,"33,722,850"
Frank Jackson,PG,22,DET,40,6,738,134,293,61,150,73,143,61,75,15,71,86,36,15,1,34,53,390,"699,115"
Josh Jackson,SG,23,DET,62,25,1560,296,707,77,257,219,450,159,218,57,197,254,143,53,47,142,178,828,"4,767,000"
Justin Jackson,SF,25,TOT,34,3,577,89,221,36,117,53,104,31,37,16,61,77,52,15,2,32,32,245,"5,109,637"
Reggie Jackson,SG,30,LAC,67,43,1544,263,585,122,282,141,303,67,82,24,168,192,205,41,7,74,127,715,"2,331,593"
Justin James,SF,24,SAC,36,0,310,52,111,14,38,38,73,21,36,9,21,30,22,8,3,15,23,139,"1,517,981"
LeBron James,PG,36,LAL,45,45,1504,422,823,104,285,318,538,178,255,29,317,346,350,48,25,168,70,1126,"39,219,566"
Mike James,PG,30,BRK,13,1,236,34,92,11,31,23,61,21,27,3,29,32,54,6,1,20,10,100,"237,648"
DaQuan Jeffries,SG,23,TOT,31,5,493,50,120,20,67,30,53,7,8,19,52,71,22,15,10,14,48,127,"1,445,697"
Ty Jerome,SG,23,OKC,33,1,788,128,287,71,168,57,119,26,34,10,81,91,120,20,6,47,61,353,"2,303,040"
Isaiah Joe,SG,21,PHI,41,1,383,48,133,39,106,9,27,18,24,6,30,36,20,12,4,11,34,153,"898,310"
Alize Johnson,PF,24,BRK,18,0,189,40,68,1,6,39,62,13,13,27,63,90,14,5,5,9,16,94,"621,587"
Cameron Johnson,PF,24,PHO,60,11,1437,203,483,117,335,86,148,50,59,33,166,199,86,37,16,40,85,573,"4,235,160"
James Johnson,PF,33,TOT,51,12,1043,146,327,31,120,115,207,45,76,32,145,177,98,42,42,55,120,368,"16,047,100"
Keldon Johnson,SF,21,SAS,69,67,1968,338,705,60,181,278,524,145,196,93,319,412,121,40,24,78,142,881,"2,048,040"
Stanley Johnson,PF,24,TOR,61,13,1006,89,233,45,137,44,96,44,55,29,124,153,89,52,18,54,116,267,"3,804,150"
Tyler Johnson,SG,28,BRK,39,3,684,72,183,48,132,24,51,18,21,6,71,77,47,14,0,17,43,210,"2,028,594"
Damian Jones,C,25,TOT,39,10,547,70,103,1,5,69,98,42,58,36,85,121,29,11,29,26,77,183,"1,487,284"
Mason Jones,SG,22,TOT,32,1,334,52,123,24,66,28,57,40,64,7,48,55,42,7,1,29,24,168,"424,544"
Tre Jones,PG,21,SAS,37,1,269,37,78,3,5,34,73,17,19,8,13,21,39,8,0,13,13,94,"898,310"
Tyus Jones,PG,24,MEM,70,9,1222,178,413,45,140,133,273,41,45,21,119,140,259,64,6,48,31,442,"8,817,143"
DeAndre Jordan,C,32,BRK,57,43,1246,190,249,0,1,190,248,46,92,117,310,427,93,17,65,85,116,426,"10,375,678"
Cory Joseph,PG,29,TOT,63,13,1446,200,426,45,132,155,294,72,88,35,124,159,213,61,18,79,139,517,"12,600,000"
Mfiondu Kabengele,PF,23,TOT,39,0,280,33,89,13,50,20,39,16,20,12,48,60,17,8,13,15,36,95,"2,432,353"
Frank Kaminsky,C,27,PHO,47,13,715,121,257,31,85,90,172,37,60,36,152,188,79,14,17,22,70,310,"1,737,145"
Luke Kennard,SG,24,LAC,63,17,1232,197,414,100,224,97,190,26,31,15,146,161,104,23,9,48,91,520,"5,273,826"
Louis King,SF,21,SAC,6,1,85,17,34,4,11,13,23,6,6,5,13,18,9,7,3,4,9,44,"49,222"
Maxi Kleber,PF,29,DAL,50,40,1341,116,275,87,212,29,63,34,37,47,213,260,68,24,35,30,105,353,"8,475,000"
Nathan Knight,PF,23,ATL,33,0,279,37,100,6,33,31,67,44,55,27,45,72,8,9,10,15,22,124,"522,989"
Kevin Knox,SF,21,NYK,42,0,464,56,143,35,89,21,54,16,20,10,51,61,19,12,6,17,37,163,"4,588,680"
John Konchar,SG,24,MEM,43,0,575,69,138,21,56,48,82,25,30,35,93,128,47,30,9,18,40,184,"2,100,000"
Furkan Korkmaz,SG,23,PHI,55,11,1062,170,424,101,269,69,155,60,82,17,96,113,82,49,9,46,64,501,"1,762,796"
Luke Kornet,C,25,TOT,31,2,348,44,101,15,59,29,42,3,6,14,53,67,24,4,32,7,20,106,"2,250,000"
Rodions Kurucs,SF,22,TOT,21,0,125,11,32,6,21,5,11,3,4,5,18,23,10,9,4,13,16,31,"1,780,152"
Kyle Kuzma,SF,25,LAL,68,32,1954,335,757,137,380,198,377,67,97,108,309,417,127,35,41,113,121,874,"3,562,178"
Anthony Lamb,SF,23,HOU,24,3,415,46,118,23,71,23,47,18,21,27,43,70,23,6,5,19,34,133,"215,330"
Jeremy Lamb,SG,28,IND,36,8,765,120,276,52,128,68,148,71,75,25,106,131,53,34,23,22,72,363,"10,500,000"
Romeo Langford,SG,21,BOS,18,4,283,21,59,5,18,16,41,9,12,12,23,35,13,6,5,10,24,56,"3,631,200"
Zach LaVine,SG,25,CHI,58,58,2034,569,1123,200,477,369,646,253,298,36,253,289,282,46,27,203,138,1591,"19,500,000"
Jake Layman,SF,26,MIN,45,11,627,91,184,23,78,68,106,26,37,13,54,67,28,29,19,26,44,231,"3,761,085"
Jalen Lecque,PG,20,IND,4,0,12,1,9,0,1,1,8,3,3,2,3,5,2,0,0,0,0,5,"1,517,981"
Damion Lee,SG,28,GSW,57,1,1079,128,274,77,194,51,80,40,44,22,158,180,73,38,8,30,89,373,"1,762,796"
Saben Lee,PG,21,DET,48,7,781,99,210,8,23,91,187,61,89,20,77,97,174,32,13,55,76,267,"516,836"
Alex Len,C,27,TOT,64,42,979,171,278,8,25,163,253,73,116,78,182,260,49,20,64,55,127,423,"3,970,648"
Kawhi Leonard,SF,29,LAC,52,52,1773,465,908,101,254,364,654,261,295,55,282,337,269,81,21,105,82,1292,"34,379,100"
Meyers Leonard,C,28,MIA,3,2,29,3,7,3,7,0,0,1,2,0,7,7,2,0,0,2,5,10,"9,400,000"
Caris LeVert,SG,26,TOT,47,39,1486,359,814,84,258,275,556,146,180,33,181,214,245,66,30,102,105,948,"16,203,704"
Damian Lillard,PG,30,POR,67,67,2398,602,1334,275,704,327,630,449,484,32,251,283,505,62,17,203,102,1928,"31,626,953"
Nassir Little,PF,20,POR,48,2,640,78,167,28,80,50,87,36,45,32,96,128,23,5,13,18,51,220,"2,210,640"
Kevon Looney,C,24,GSW,61,34,1161,108,197,4,17,104,180,31,48,117,205,322,119,21,22,37,136,251,"4,821,429"
Brook Lopez,C,32,MIL,70,70,1902,322,640,95,281,227,359,120,142,104,243,347,50,40,103,64,149,859,"12,697,675"
Robin Lopez,C,32,WAS,71,9,1354,269,425,5,18,264,407,99,137,141,131,272,55,15,44,75,109,642,"7,300,000"
Didi Louzada,SF,21,NOP,3,0,56,3,13,2,8,1,5,0,0,1,2,3,3,2,0,3,5,8,"123,056"
Kevin Love,PF,32,CLE,25,25,622,103,252,57,156,46,96,42,51,17,169,186,63,16,2,38,26,305,"31,258,256"
Kyle Lowry,PG,34,TOR,46,46,1601,260,596,131,331,129,265,140,160,35,212,247,338,45,14,126,143,791,"30,500,000"
Trey Lyles,PF,25,SAS,23,9,358,43,90,14,40,29,50,15,23,9,77,86,14,6,1,6,13,115,"5,500,000"
Will Magnay,C,22,NOP,1,0,3,0,1,0,1,0,0,0,0,0,0,0,0,0,0,1,1,0,"341,481"
Thon Maker,C,23,CLE,8,0,76,10,18,0,2,10,16,10,11,8,10,18,4,2,4,3,7,30,"1,737,145"
Terance Mann,SG,24,LAC,67,10,1263,178,350,38,91,140,259,78,94,56,186,242,104,29,13,40,126,472,"1,517,981"
Nico Mannion,PG,19,GSW,30,1,364,39,114,22,60,17,54,23,28,6,40,46,70,16,1,31,29,123,"449,115"
Lauri Markkanen,PF,23,CHI,51,26,1317,250,521,119,296,131,225,76,92,35,233,268,45,26,15,52,75,695,"6,731,508"
Naji Marshall,SF,23,NOP,32,10,700,82,209,29,83,53,126,53,75,15,133,148,88,26,10,38,58,246,"538,391"
Caleb Martin,SF,25,CHO,53,3,818,96,256,31,125,65,131,41,64,31,110,141,67,37,12,33,62,264,"1,517,981"
Cody Martin,SF,25,CHO,52,10,849,83,188,16,58,67,130,25,43,52,109,161,86,37,12,40,52,207,"1,517,981"
Jeremiah Martin,PG,24,CLE,9,0,75,9,33,3,12,6,21,1,5,2,5,7,4,5,2,6,1,22,"58,452"
Kelan Martin,SF,25,IND,35,0,322,62,138,24,60,38,78,9,10,18,60,78,17,10,10,16,35,157,"1,445,697"
Garrison Mathews,SG,24,WAS,64,24,1038,97,237,76,198,21,39,84,95,16,71,87,26,29,7,10,106,354,"688,052"
Dakota Mathias,SG,25,PHI,8,2,123,19,48,8,26,11,22,2,6,1,6,7,13,1,3,1,7,48,"86,132"
Wesley Matthews,SG,34,LAL,58,10,1130,89,252,66,197,23,55,35,41,20,73,93,54,38,17,26,80,279,"3,623,000"
Tyrese Maxey,SG,20,PHI,61,8,935,198,429,31,103,167,326,61,70,11,93,104,120,26,13,41,79,488,"2,478,840"
Skylar Mays,SG,23,ATL,33,0,269,44,98,14,40,30,58,22,25,10,25,35,30,14,2,9,15,124,"532,218"
Patrick McCaw,SF,25,TOR,5,0,33,1,1,0,0,1,1,3,3,1,2,3,4,2,0,0,6,5,"4,000,000"
CJ McCollum,SG,29,POR,47,47,1600,405,884,169,420,236,464,108,133,30,155,185,223,44,21,65,87,1087,"29,354,152"
Jaden McDaniels,PF,20,MIN,63,27,1511,164,367,72,198,92,169,27,45,52,180,232,71,35,60,47,172,427,"1,964,760"
Jalen McDaniels,SF,23,CHO,47,18,904,133,284,35,105,98,179,45,64,45,124,169,53,28,19,45,95,346,"1,517,981"
Doug McDermott,PF,29,IND,66,29,1619,354,665,111,286,243,379,80,98,60,161,221,85,20,6,53,117,899,"7,333,333"
Sean McDermott,SF,24,MEM,18,0,158,13,33,5,22,8,11,8,8,6,13,19,4,2,3,4,8,39,"449,115"
JaVale McGee,C,33,TOT,46,2,678,144,282,5,24,139,258,44,67,77,162,239,39,19,54,60,121,337,"4,200,000"
Rodney McGruder,SG,29,DET,16,2,194,37,70,11,24,26,46,6,8,8,14,22,16,8,1,7,12,91,"5,192,307"
Alfonzo McKinnie,SF,28,LAL,39,0,258,48,93,16,39,32,54,10,18,22,32,54,6,7,0,5,26,122,"1,762,796"
Jordan McLaughlin,PG,24,MIN,51,2,938,100,242,33,92,67,150,23,30,21,87,108,193,51,6,51,44,256,"503,760"
Ben McLemore,SG,27,TOT,53,5,905,135,365,97,280,38,85,39,53,15,85,100,39,23,9,42,88,406,"2,893,630"
De'Anthony Melton,PG,22,MEM,52,1,1045,172,393,87,211,85,182,41,51,30,131,161,132,60,31,66,85,472,"9,571,712"
Sam Merrill,SG,24,MIL,30,2,233,32,72,21,47,11,25,4,4,6,24,30,21,8,1,10,17,89,"898,310"
Chimezie Metu,C,23,SAC,36,6,488,91,179,13,37,78,142,31,43,31,81,112,28,14,18,29,59,226,"910,895"
Khris Middleton,SF,29,MIL,68,68,2269,511,1074,151,365,360,709,212,236,54,352,406,370,74,9,178,160,1385,"33,051,724"
Darius Miller,SF,30,OKC,18,0,197,22,48,17,42,5,6,12,12,2,22,24,21,13,5,8,13,73,"7,000,000"
Paul Millsap,PF,35,DEN,56,36,1162,191,401,49,143,142,258,71,98,76,186,262,98,51,36,51,111,502,"10,100,000"
Shake Milton,SG,24,PHI,63,4,1461,300,667,71,203,229,464,146,176,33,115,148,193,39,18,103,130,817,"1,701,593"
Donovan Mitchell,PG,24,UTA,53,53,1771,478,1091,178,461,300,630,267,316,50,185,235,277,52,15,147,117,1401,"5,195,501"
Adam Mokoka,SG,22,CHI,14,0,56,7,19,1,10,6,9,0,1,1,4,5,5,2,1,5,5,15,"449,115"
Malik Monk,SG,22,CHO,42,0,878,173,399,85,212,88,187,59,72,14,87,101,87,19,4,55,47,490,"5,345,687"
E'Twaun Moore,SG,31,PHO,27,1,389,55,121,11,35,44,86,12,14,14,31,45,40,15,5,23,32,133,"2,331,593"
Ja Morant,PG,21,MEM,63,63,2053,430,957,73,241,357,716,271,372,59,193,252,465,57,13,203,87,1204,"9,166,800"
Juwan Morgan,PF,23,UTA,29,0,147,14,30,4,13,10,17,3,7,9,19,28,9,4,1,4,21,35,"1,517,981"
Marcus Morris,PF,31,LAC,57,29,1502,276,584,140,296,136,288,73,89,35,199,234,58,34,15,57,117,765,"14,883,721"
Markieff Morris,PF,31,LAL,61,27,1200,153,378,65,209,88,169,36,50,48,218,266,73,22,19,54,105,407,"2,331,593"
Monte Morris,PG,25,DEN,47,13,1196,186,387,51,134,135,253,58,73,11,85,96,150,34,13,34,48,481,"1,723,707"
Mychal Mulder,PG,26,GSW,60,6,766,119,265,85,214,34,51,14,22,8,52,60,26,12,12,16,56,337,"1,517,981"
Dejounte Murray,PG,24,SAS,67,67,2139,441,974,63,199,378,775,106,134,58,415,473,363,101,7,117,135,1051,"14,286,000"
Jamal Murray,PG,23,DEN,48,48,1704,378,792,129,316,249,476,133,153,37,157,194,231,64,13,108,95,1018,"27,285,000"
Mike Muscala,C,29,OKC,35,0,645,119,267,68,184,51,83,33,36,19,113,132,28,8,11,21,54,339,"2,283,034"
Abdel Nader,SF,27,PHO,24,0,355,57,116,18,43,39,73,28,37,7,55,62,19,10,9,19,34,160,"1,752,950"
Aaron Nesmith,SF,21,BOS,46,1,669,78,178,40,108,38,70,22,28,28,99,127,23,15,9,23,87,218,"3,458,400"
Raul Neto,PG,28,WAS,64,22,1403,209,447,64,164,145,283,75,85,28,128,156,146,73,6,53,109,557,"1,882,867"
Georges Niang,PF,27,UTA,72,10,1154,177,405,124,292,53,113,22,23,28,148,176,59,25,8,51,116,500,"1,783,557"
Zeke Nnaji,PF,20,DEN,42,1,397,50,104,24,59,26,45,12,15,14,51,65,10,8,4,7,29,136,"2,379,840"
Nerlens Noel,C,26,NYK,64,41,1547,137,223,0,3,137,220,50,70,142,266,408,46,70,141,65,176,324,"5,000,000"
Jaylen Nowell,SG,21,MIN,42,0,759,142,335,50,150,92,185,45,55,19,76,95,62,22,12,28,72,379,"1,517,981"
Frank Ntilikina,PG,22,NYK,33,4,322,29,79,23,48,6,31,8,18,6,25,31,19,18,4,11,45,89,"6,176,578"
Kendrick Nunn,PG,25,MIA,56,44,1650,319,658,122,320,197,338,56,60,21,158,179,148,52,14,80,108,816,"1,663,861"
James Nunnally,SF,30,NOP,9,0,48,5,13,4,12,1,1,1,2,2,7,9,3,0,0,2,1,15,"107,674"
David Nwaba,SF,28,HOU,30,9,679,106,218,17,63,89,155,47,68,40,78,118,31,30,21,17,60,276,"1,824,003"
Jordan Nwora,SF,22,MIL,30,2,274,62,135,28,62,34,73,19,25,9,51,60,7,16,7,24,22,171,"898,310"
Royce O'Neale,SF,27,UTA,71,71,2241,175,394,107,278,68,116,39,46,88,397,485,181,57,32,83,182,496,"8,500,000"
Semi Ojeleye,PF,26,BOS,56,15,950,89,221,58,158,31,63,24,32,31,116,147,37,17,0,21,56,260,"1,752,950"
Jahlil Okafor,C,25,DET,27,2,347,63,102,2,9,61,93,17,24,23,43,66,13,6,5,21,39,145,"1,882,867"
Chuma Okeke,PF,22,ORL,45,19,1133,135,324,49,141,86,183,30,40,42,139,181,101,48,22,38,48,349,"3,121,080"
Josh Okogie,SG,22,MIN,59,37,1197,102,254,29,108,73,146,83,108,63,93,156,63,54,28,43,123,316,"2,651,040"
Onyeka Okongwu,C,20,ATL,50,4,601,96,149,0,3,96,146,36,57,62,101,163,18,23,33,29,100,228,"5,813,640"
Isaac Okoro,SG,20,CLE,67,67,2173,235,559,62,214,173,345,114,157,68,138,206,128,62,24,86,185,646,"6,400,920"
KZ Okpala,PF,21,MIA,37,9,447,36,96,12,50,24,46,8,15,21,47,68,19,10,11,15,59,92,"1,517,981"
Victor Oladipo,SG,28,TOT,33,33,1080,235,576,78,239,157,337,104,138,12,148,160,151,46,14,83,81,652,"21,000,000"
Cameron Oliver,SF,24,HOU,4,0,87,19,33,4,13,15,20,1,4,5,16,21,5,2,4,3,11,43,"43,070"
Kelly Olynyk,C,29,TOT,70,62,1997,337,697,126,368,211,329,145,175,87,402,489,203,79,42,126,207,945,"12,819,650"
Miye Oni,SG,23,UTA,54,0,519,35,99,30,88,5,11,5,6,23,61,84,28,11,8,16,61,105,"1,517,981"
Cedi Osman,SF,25,CLE,59,26,1510,219,586,99,324,120,262,76,95,38,163,201,174,53,9,80,119,613,"8,840,580"
Daniel Oturu,C,21,LAC,30,0,161,22,52,1,5,21,47,9,12,21,27,48,10,4,7,9,24,54,"898,310"
Jabari Parker,PF,25,TOT,13,0,165,30,55,2,11,28,44,10,13,10,32,42,11,1,5,10,13,72,"6,930,729"
Eric Paschall,PF,24,GSW,40,2,695,148,298,18,54,130,244,67,94,28,100,128,51,12,7,43,68,381,"1,517,981"
Patrick Patterson,PF,31,LAC,38,5,582,72,165,40,112,32,53,13,17,19,56,75,29,14,8,11,45,197,"3,814,771"
Justin Patton,C,23,HOU,13,6,247,29,70,9,34,20,36,3,4,14,35,49,14,12,14,4,34,70,"267,623"
Chris Paul,PG,35,PHO,70,70,2199,439,879,102,258,337,621,169,181,25,287,312,622,99,19,156,166,1149,"41,358,814"
Cameron Payne,PG,26,PHO,60,1,1079,191,395,73,166,118,229,50,56,16,128,144,217,36,16,60,97,505,"1,977,011"
Elfrid Payton,PG,26,NYK,63,63,1484,269,622,28,98,241,524,73,107,64,152,216,203,47,9,103,116,639,"4,767,000"
Gary Payton II,PG,28,GSW,10,0,40,10,13,2,4,8,9,3,4,2,9,11,1,6,1,1,8,25,"249,864"
Norvel Pelle,C,27,TOT,13,0,84,8,15,0,0,8,15,4,6,6,13,19,2,1,9,3,14,20,"1,014,905"
Reggie Perry,PF,20,BRK,26,0,211,32,78,4,21,28,57,10,13,27,46,73,14,6,6,15,40,78,"489,148"
Theo Pinson,SG,25,NYK,17,0,34,1,9,0,8,1,1,0,0,0,5,5,1,0,0,1,4,2,"802,182"
Mason Plumlee,C,30,DET,56,56,1499,234,381,0,7,234,374,113,169,145,374,519,202,43,50,105,186,581,"8,000,000"
Jakob Poeltl,C,25,SAS,69,51,1845,265,430,0,0,265,430,63,124,219,328,547,134,47,123,83,172,593,"8,101,852"
Vincent Poirier,C,27,PHI,10,0,39,3,12,0,1,3,11,2,6,6,8,14,2,0,3,4,8,8,"2,619,207"
Aleksej Pokusevski,PF,19,OKC,45,28,1090,139,408,58,207,81,201,31,42,30,182,212,97,20,42,99,58,367,"2,964,840"
Jordan Poole,SG,21,GSW,51,7,988,205,474,97,276,108,198,105,119,15,77,92,99,26,9,51,86,612,"2,063,280"
Jontay Porter,PF,21,MEM,11,0,54,8,15,3,8,5,7,3,5,4,10,14,1,3,1,7,12,22,"1,900,000"
Bobby Portis,C,25,MIL,66,7,1372,313,598,74,157,239,441,54,73,124,342,466,71,52,26,56,115,754,"3,623,000"
Dwight Powell,C,29,DAL,58,19,966,120,194,5,21,115,173,97,124,80,154,234,63,36,30,40,135,342,"11,080,125"
Norman Powell,SG,27,TOT,69,58,2205,438,918,171,416,267,502,236,271,42,173,215,129,82,18,119,160,1283,"10,865,952"
Taurean Prince,PF,26,TOT,41,10,905,131,327,62,155,69,172,65,76,19,123,142,76,28,23,47,75,389,"12,250,000"
Payton Pritchard,SG,23,BOS,66,4,1268,184,418,102,248,82,170,40,45,33,125,158,120,37,9,53,104,510,"2,035,800"
Immanuel Quickley,PG,21,NYK,64,3,1243,229,580,118,303,111,277,155,174,25,112,137,127,30,12,58,114,731,"2,105,520"
Jahmi'us Ramsey,SG,19,SAC,13,0,94,15,38,5,19,10,19,5,5,2,8,10,6,4,1,3,8,40,"1,000,000"
Chasson Randle,PG,27,ORL,41,5,837,92,237,44,130,48,107,38,48,7,75,82,74,22,5,46,64,266,"279,927"
Julius Randle,PF,26,NYK,71,71,2667,602,1321,160,389,442,932,348,429,84,639,723,427,64,18,241,225,1712,"19,845,000"
Cam Reddish,SF,21,ATL,26,21,750,96,263,33,126,63,137,67,82,22,82,104,35,33,9,34,68,292,"4,458,000"
Paul Reed,PF,21,PHI,26,0,177,42,78,0,6,42,72,4,8,30,31,61,12,10,13,12,29,88,"609,128"
Naz Reid,C,21,MIN,70,15,1347,304,581,61,174,243,407,115,166,82,240,322,72,34,76,69,179,784,"1,517,981"
Nick Richards,PF,23,CHO,18,0,63,4,9,0,1,4,8,7,11,4,7,11,2,0,0,3,7,15,"1,000,000"
Josh Richardson,SG,27,DAL,59,56,1790,264,618,88,267,176,351,99,108,51,144,195,153,61,24,79,130,715,"10,865,952"
Grant Riller,PG,23,CHO,7,0,27,8,12,2,4,6,8,0,0,0,1,1,3,1,0,1,0,18,"449,115"
Austin Rivers,SG,28,TOT,36,7,845,104,245,55,149,49,96,22,31,8,74,82,81,30,2,36,64,285,"3,929,049"
Andre Roberson,SG,29,BRK,5,0,63,2,14,1,8,1,6,1,2,7,8,15,4,3,1,2,4,6,"411,639"
Duncan Robinson,SF,26,MIA,72,72,2262,315,717,250,613,65,104,62,75,7,243,250,127,43,20,81,181,942,"1,663,861"
Glenn Robinson III,SF,27,SAC,23,2,369,42,99,16,44,26,55,21,23,11,34,45,20,4,3,11,23,121,"1,165,322"
Jerome Robinson,SG,23,WAS,17,6,305,28,95,11,42,17,53,16,20,4,34,38,25,12,6,19,31,83,"3,737,520"
Justin Robinson,PG,23,OKC,9,0,88,7,21,4,14,3,7,3,5,1,6,7,9,3,0,2,10,21,"198,040"
Mitchell Robinson,C,22,NYK,31,29,853,115,176,0,0,115,176,26,53,113,139,252,17,35,45,26,86,256,"1,663,861"
Isaiah Roby,PF,22,OKC,61,34,1425,207,429,32,109,175,320,87,117,89,252,341,107,52,37,113,162,533,"1,517,981"
Rajon Rondo,PG,34,TOT,45,3,770,95,215,36,89,59,126,16,17,18,92,110,199,37,4,79,53,242,"7,500,000"
Derrick Rose,PG,32,TOT,50,3,1279,287,611,50,129,237,482,110,127,20,110,130,209,49,19,78,56,734,"7,682,926"
Terrence Ross,SG,29,ORL,46,2,1347,254,616,89,264,165,352,120,138,15,143,158,108,47,21,74,88,717,"13,500,000"
Terry Rozier,SG,26,CHO,69,69,2383,510,1134,222,571,288,563,165,202,47,255,302,293,87,26,128,119,1407,"18,900,000"
Ricky Rubio,PG,30,MIN,68,51,1772,193,498,66,214,127,284,130,150,28,195,223,433,98,4,111,139,582,"17,000,000"
D'Angelo Russell,PG,24,MIN,42,26,1196,281,652,120,310,161,342,114,149,16,95,111,244,45,18,112,68,796,"28,649,250"
Domantas Sabonis,PF,24,IND,62,62,2231,484,904,52,162,432,742,240,328,150,592,742,415,76,33,213,203,1260,"19,800,000"
JaKarr Sampson,PF,27,IND,29,4,316,56,113,3,15,53,98,19,29,27,50,77,4,2,14,15,52,134,"1,882,867"
Mike Scott,PF,32,PHI,51,12,852,76,211,53,155,23,56,8,12,11,109,120,40,24,14,19,72,213,"5,005,350"
Jay Scrubb,SG,20,LAC,4,1,84,14,36,2,9,12,27,5,5,2,12,14,1,4,0,7,5,35,"449,115"
Collin Sexton,SG,22,CLE,60,60,2115,525,1105,98,264,427,841,312,383,58,129,187,262,62,10,167,157,1460,"4,991,880"
Landry Shamet,SG,23,BRK,61,12,1403,186,456,129,333,57,123,66,78,11,101,112,99,31,10,48,93,567,"2,090,040"
Iman Shumpert,SG,30,BRK,2,0,11,1,4,0,3,1,1,0,0,1,0,1,0,1,0,1,0,2,"803,044"
Pascal Siakam,PF,26,TOR,56,56,2006,437,961,73,246,364,715,249,301,95,310,405,250,64,37,130,174,1196,"30,559,200"
Chris Silva,PF,24,TOT,15,0,92,10,16,1,1,9,15,11,15,7,20,27,6,1,6,10,24,32,"1,517,981"
Ben Simmons,PG,24,PHI,58,58,1877,325,583,3,10,322,573,176,287,93,324,417,401,93,35,173,171,829,"30,559,200"
Anfernee Simons,SG,21,POR,64,0,1104,168,401,120,282,48,119,46,57,14,126,140,89,18,8,43,96,502,"2,252,040"
Deividas Sirvydis,SG,20,DET,20,0,133,14,40,10,28,4,12,3,6,0,29,29,5,2,0,5,9,41,"898,310"
Marcus Smart,PG,26,BOS,48,45,1581,203,510,93,282,110,228,128,162,36,131,167,273,72,23,96,126,627,"12,946,428"
Jalen Smith,PF,20,PHO,27,1,156,22,50,4,17,18,33,5,7,7,30,37,4,1,5,7,16,53,"4,245,720"
Tony Snell,SG,29,ATL,47,23,992,88,171,62,109,26,62,11,11,18,94,112,59,13,11,21,75,249,"12,178,571"
Cassius Stanley,SG,21,IND,24,0,93,13,43,3,13,10,30,7,9,8,12,20,1,1,2,1,14,36,"470,690"
Lamar Stevens,PF,23,CLE,40,0,499,62,136,4,25,58,111,37,51,24,72,96,25,17,13,23,53,165,"1,000,000"
Isaiah Stewart,C,19,DET,68,14,1455,226,409,21,63,205,346,64,92,159,294,453,59,39,86,67,184,537,"3,121,080"
Max Strus,SF,24,MIA,39,0,507,85,187,50,148,35,39,16,24,5,36,41,24,11,2,8,43,236,"647,098"
Edmond Sumner,SG,25,IND,53,24,861,148,282,35,88,113,194,68,83,18,76,94,49,33,10,51,88,399,"2,160,000"
Jae'Sean Tate,SF,25,HOU,70,58,2043,316,625,60,195,256,430,102,147,132,242,374,178,85,36,98,222,794,"1,445,697"
Jayson Tatum,SF,22,BOS,64,64,2290,605,1318,187,485,418,833,295,340,50,422,472,276,75,31,171,122,1692,"9,897,120"
Jeff Teague,PG,32,TOT,55,7,950,123,284,36,82,87,202,89,105,15,73,88,132,34,12,64,56,371,"3,372,826"
Garrett Temple,SG,34,CHI,56,25,1528,158,381,67,200,91,181,40,50,29,131,160,124,43,30,58,126,423,"4,767,000"
Tyrell Terry,PG,20,DAL,11,0,56,5,16,0,7,5,9,1,3,0,6,6,6,5,0,2,2,11,"1,289,846"
Daniel Theis,C,28,TOT,65,51,1601,252,466,49,152,203,314,74,110,93,263,356,108,41,57,66,167,627,"5,000,000"
Brodric Thomas,SG,24,TOT,32,1,399,39,108,16,59,23,49,31,46,8,45,53,30,15,10,22,40,125,"412,202"
Isaiah Thomas,PG,31,NOP,3,0,48,9,27,3,12,6,15,2,2,1,3,4,5,1,0,6,3,23,"159,698"
Khyri Thomas,SG,24,HOU,5,2,153,32,66,9,27,23,39,9,9,7,11,18,25,9,6,6,8,82,"1,061,283"
Matt Thomas,SG,26,TOT,45,0,326,50,127,27,80,23,47,12,14,7,37,44,19,4,0,14,18,139,"1,517,981"
Tristan Thompson,PF,29,BOS,54,43,1287,169,326,0,3,169,323,71,120,169,270,439,67,24,33,62,119,409,"9,258,000"
Sindarius Thornwell,SG,26,TOT,21,1,217,15,46,7,23,8,23,4,8,3,15,18,21,13,2,7,15,41,"1,235,889"
Matisse Thybulle,SG,23,PHI,65,8,1298,102,243,43,143,59,100,8,18,30,94,124,63,105,71,32,127,255,"2,711,280"
Killian Tillie,C,22,MEM,18,1,182,19,57,10,33,9,24,9,11,6,18,24,8,5,8,2,20,57,"449,115"
Anthony Tolliver,PF,35,PHI,11,0,99,4,17,4,14,0,3,5,6,3,7,10,2,3,2,3,7,17,"614,838"
Obi Toppin,PF,22,NYK,62,0,683,104,209,26,85,78,124,19,26,26,112,138,29,17,15,23,55,253,"4,862,040"
Juan Toscano-Anderson,SG,27,GSW,53,16,1107,121,209,37,92,84,117,22,31,29,205,234,150,41,26,61,111,301,"943,963"
Axel Toupane,SF,28,MIL,8,1,61,4,11,1,2,3,9,5,7,0,6,6,4,2,3,0,6,14,"196,872"
Karl-Anthony Towns,C,25,MIN,50,50,1689,425,875,122,315,303,560,267,311,133,396,529,225,39,57,160,186,1239,"29,467,800"
Rayjon Tucker,PG,23,PHI,14,0,68,9,18,2,7,7,11,14,19,1,10,11,6,2,0,4,8,34,"693,755"
Myles Turner,C,24,IND,47,47,1455,206,432,69,206,137,226,111,142,63,243,306,48,40,159,67,165,592,"18,000,000"
Denzel Valentine,SG,27,CHI,62,3,1036,155,416,80,242,75,174,16,17,24,173,197,105,30,7,42,70,406,"4,642,800"
Jarred Vanderbilt,PF,21,MIN,64,30,1139,143,236,1,5,142,231,57,102,118,250,368,76,64,46,53,123,344,"1,663,861"
Fred VanVleet,SG,26,TOR,52,52,1899,338,870,174,476,164,394,169,191,32,188,220,328,87,37,95,119,1019,"21,250,000"
Devin Vassell,SF,20,SAS,62,7,1056,123,303,52,150,71,153,43,51,24,150,174,56,43,18,22,88,341,"4,033,440"
Gabe Vincent,PG,24,MIA,50,7,655,88,233,46,149,42,84,20,23,10,46,56,67,21,2,34,79,242,"660,750"
Noah Vonleh,PF,25,BRK,4,0,11,0,3,0,2,0,1,0,0,0,1,1,1,0,0,2,2,0,"427,725"
Dean Wade,PF,24,CLE,63,19,1212,134,311,78,213,56,98,30,39,38,177,215,74,35,21,30,78,376,"1,517,981"
Moritz Wagner,C,23,TOT,45,24,722,104,229,31,91,73,138,71,87,27,119,146,50,26,18,43,108,310,"2,383,915"
Kemba Walker,PG,30,BOS,43,43,1369,284,676,127,353,157,323,134,149,16,154,170,212,48,12,88,61,829,"34,379,100"
John Wall,PG,30,HOU,40,40,1288,293,726,79,249,214,477,158,211,17,112,129,275,42,31,141,46,823,"41,254,920"
Brad Wanamaker,PG,31,TOT,61,0,1053,115,299,16,85,99,214,90,101,18,87,105,174,43,11,71,94,336,"2,250,000"
Yuta Watanabe,SF,26,TOR,50,4,723,79,180,36,90,43,90,24,29,36,123,159,40,26,19,19,57,218,"737,996"
Tremont Waters,PG,23,BOS,26,3,238,34,84,15,38,19,46,16,17,5,16,21,62,15,1,27,17,99,"712,278"
Paul Watson,SF,26,TOR,27,2,297,38,82,30,64,8,18,5,8,4,41,45,17,6,3,9,36,111,"1,445,697"
Quinndary Weatherspoon,SG,24,SAS,20,0,121,16,35,1,6,15,29,13,16,3,8,11,8,8,2,10,18,46,"449,115"
Russell Westbrook,PG,32,WAS,65,65,2369,544,1238,86,273,458,965,271,413,109,641,750,763,89,23,312,190,1445,"41,358,814"
Coby White,PG,20,CHI,69,54,2156,375,902,163,454,212,448,128,142,28,256,284,328,38,15,156,179,1041,"5,572,680"
Derrick White,SG,26,SAS,36,32,1064,186,453,84,243,102,210,97,114,13,94,107,127,26,36,45,91,553,"3,516,284"
Hassan Whiteside,C,31,SAC,36,4,546,126,224,0,1,126,223,41,79,61,154,215,20,9,46,40,73,293,"2,320,044"
Greg Whittington,PF,27,DEN,4,0,12,0,3,0,2,0,1,0,0,0,0,0,0,0,0,0,0,0,"332,252"
Andrew Wiggins,PF,25,GSW,71,71,2364,505,1058,140,368,365,690,170,238,82,265,347,167,67,70,126,159,1320,"29,542,010"
Grant Williams,PF,22,BOS,63,9,1138,108,247,48,129,60,118,30,51,48,130,178,64,32,24,56,161,294,"2,498,760"
Kenrich Williams,PF,26,OKC,66,13,1426,219,411,52,117,167,294,36,63,84,189,273,152,55,17,76,143,526,"2,000,000"
Patrick Williams,PF,19,CHI,71,71,1983,255,528,54,138,201,390,91,125,66,261,327,99,64,46,98,126,655,"7,068,360"
Robert Williams,C,23,BOS,52,13,985,186,258,0,2,186,256,45,73,133,225,358,94,43,91,52,105,417,"2,029,920"
Zion Williamson,PF,20,NOP,61,61,2026,634,1037,10,34,624,1003,369,529,167,274,441,226,57,39,167,135,1647,"10,245,480"
Dylan Windler,SF,24,CLE,31,0,513,57,130,26,77,31,53,21,27,20,87,107,33,19,12,32,37,161,"2,137,440"
Justise Winslow,SF,24,MEM,26,1,507,74,210,10,54,64,156,20,35,18,100,118,50,15,12,37,47,178,"13,000,000"
Cassius Winston,PG,22,WAS,22,0,98,14,33,8,17,6,16,5,6,0,9,9,12,2,1,5,8,41,"449,115"
James Wiseman,C,19,GSW,39,27,836,191,368,12,38,179,330,54,86,55,171,226,26,11,36,60,121,448,"8,730,240"
Christian Wood,C,25,HOU,41,41,1326,329,640,77,206,252,434,125,198,76,319,395,71,34,48,80,88,860,"13,015,874"
Delon Wright,SG,28,TOT,63,39,1748,240,518,64,172,176,346,101,126,65,204,269,278,101,30,83,75,645,"9,000,000"
Thaddeus Young,PF,32,CHI,68,23,1652,370,662,12,45,358,617,71,113,168,255,423,291,74,40,137,152,823,"13,545,000"
Trae Young,PG,22,ATL,63,63,2125,487,1112,136,397,351,715,484,546,38,207,245,594,53,12,261,111,1594,"6,571,800"
Cody Zeller,C,28,CHO,48,21,1005,181,324,4,28,177,296,85,119,119,209,328,86,27,17,51,121,451,"15,415,730"
Ivica Zubac,C,23,LAC,72,33,1609,257,394,1,4,256,390,135,171,189,330,519,90,24,62,81,187,650,"7,000,000"
